1111111111111111111
10PC0E0000C00C00001
1111111111111111111