1111111111111
10C10000000C1
10000000000D1
1P0010E000011
1111111111111