1111111111111
10010000000C1
1000000000001
1P0010E000011
1111111111111