1111111111111
10C10000C00C1
10000C0000001
1P0010E000011
1111111111111