111111111111111111
10C10CC0C00C00C001
10000C000000CC0C01
1P0C10E0CCC1000001
111111111111111111