111111111111111111
10C10CC0C00C00C001
10000C000000CC0C11
1P0C10E0CCC1000001
10C100C0C00C00C001
11110C000000C11101
10C100C0C00C00C001
10C10C11100C00C111
100000100000CC0C01
10C10CC0C00C00C001
10C10C11100C00C111
100000100000CC0C01
111100000000C11101
10C10C00C00C00C001
10C10C11100C00C111
10000C100000CC0C01
10C10CC0C00C00C001
11010C11100C00C111
1000C0100000CC0C01
10100C000000C11101
10C10CC0C00C00C001
10C10C11100C00C111
100000100000CC0C01
100100C0C00C00C001
10010011100C00C111
111100000000C11101
100100C0C00000C001
10010C11100000C111
10000C100000CC0C01
10C100C0C00C00C001
10C10011100000C111
100000100000CC0C01
10C10CC0C00000C001
10C10011100C00C111
100000100000CC0C01
10C10CC0C00C00C001
10C10C11100C00C111
100000100000CC0C01
111111111111111111