1111111111111
00010000000C1
1000000000000
1P0010E000011
1111111111111