111111111111111111111111111111
100000000000000000000000000001
100P00000000000000000000000001
1000000000000000000D0000000001
100000001000000000000000000001
100000001000000000000000000001
1DD000001111111111111111111111
10D000000000000000000000000D01
10000000000000000D000000000001
100000000000000000000000000001
100000000000000000000000000001
100000000000000000000000000001
111111111111100000000000000001
100000000000100000000000000001
1000C0000000100000000000000001
100000000000100000000000000001
10011111111110C000000000E00001
100000000000000000000000000001
111111111111111111111111111111