1111111111111
10C1D00D000C1
1000D000D00D1
1P0010E000011
1111111111111