1111111111111
10D10C0C000C1
1C00011111C01
1P0011E000011
1111111111111
