1111111111111
10C10000C00C1
10000C00D0001
1P0010E000011
1111111111111