111111111111111111
10C10CC0CD0C00C001
1D000C000000CC0C01
1P0C10E0CCC1000D01
111111111111111111